ID	ClassUse
Swordfaire	Hero, Swordmaster, Assassin, Enlightened One, Mortal Savant
Lancefaire	High Lord, Paladin, Great Lord, Falcon Knight, Great Knight
Axefaire	Armored Lord, Fortress Knight, Wyvern Rider, Warrior, Emperor, Wyvern Lord, Great Knight, War Master
Bowfaire	Wyvern Master, Sniper, Barbarossa, Bow Knight
Fistfaire	Grappler, War Master
Black Tomefaire	Warlock, Mortal Savant, Dark Knight
White Tomefaire	Holy Knight
Dark Tomefaire	Dark Knight
Sword Crit +10	Swordmaster
Axe Crit +10	Warrior
Avo +10	Pegasus Knight, Falcon Knight, Wyvern Lord
Crit +20	War Master
Fiendish Blow	Dark Bishop
Charm	Armored Lord, High Lord, Wyvern Master, Emperor, Great Lord, Barbarossa
Heartseeker	Dark Mage, Dark Bishop
Fire	Mage
Miasma Î”	Dark Mage, Dark Bishop
Heal	Priest
Miracle	Paladin, Bishop, Enlightened One, Holy Knight
Vantage	Hero
Dance	Dancer
Steal	Thief
Locktouch	Thief, Assassin
Stealth	Assassin
Canto	Cavalier, Pegasus Knight, Wyvern Master, Paladin, Wyvern Lord, Barbarossa, Falcon Knight, Wyvern Lord, Great Knight, Bow Knight, Holy Knight, Dark Knight
Bowrange +1	Archer, Sniper
Bowrange +2	Bow Knight
Unarmed Combat	Brawler, Grappler
Black Magic Uses x2	Warlock, Gremory
Dark Magic Uses x2	Gremory
White Magic Uses x2	Bishop, Gremory
White Magic Heal +5	Priest
White Magic Heal +10	Bishop
Weight -5	Fortress Knight